++++++~X
......=H
H=......
~===~==H
..=+.==~
..==.H~@
@@@=.H~@
@@@=.==@
@@@=.~H@